..#.......
..#.......
.....##...
.....#..#.
..........
..##..####
...#......
##........
.....#...#
#......#.#
