.###...#..
..#.......
......#.##
##....#...
#..#....##
......#...
........#.
........#.
.#......#.
..........
