#..#...#..
#..#......
#........#
...#.....#
..........
..#.#.....
..#.#.....
..#.##...#
.........#
#......#..
