..........
...#......
#.##...#.#
..........
##...#....
...#.#....
#....#....
##........
.#..#.#...
....#.#...
