..........
.##.......
.##.##....
....#.....
.......##.
..##.#....
..#.......
....#.#...
.#....#..#
...##.....
