...###....
.....#....
##.....#.#
..........
..........
.....##...
.........#
#.......##
#.#.......
#.....#.##
