..##......
......#...
....#.#.#.
#.........
.....##...
..#..#..##
..##......
..#.......
..........
###.....#.
