.#...#..#.
.##..#....
.......#..
#.#.#.....
..#...##..
......#...
...##.....
...#.....#
...#.....#
..........
