....#...#.
........#.
..##......
..#......#
#.......##
..........
##........
.....#...#
...#.##..#
.#....#...
