.#.###....
..........
.........#
.##.#.....
....#...#.
........##
.#......#.
.#........
..........
#.#...###.
